0 0 0 5 0 0
1 1 3 2 1 1
0 0 2 2 0 0
0 1 0 3 1 0
0 5 3 2 4 4
0 0 1 4 0 0
0 5 0 5 5 0
0 0 0 0 0 2
0 0 0 0 0 0
0 0 0 0 0 0