0 4 6 1 4 5
1 1 3 2 1 1
0 0 2 2 0 0
1 1 6 6 1 1
0 0 5 5 0 0
5 4 5 5 4 5
0 5 0 0 5 0
0 0 0 0 0 0
0 0 0 0 0 0
0 0 0 0 0 0